//MAP CONVERTED BY dmm2tgm.py THIS HEADER COMMENT PREVENTS RECONVERSION, DO NOT REMOVE
"aa" = (
/obj/structure/table/reinforced,
/obj/item/reagent_containers/cup/bottle/capsaicin{
	pixel_x = -20
	},
/obj/item/rag{
	pixel_x = -4
	},
/turf/open/floor/iron/checker,
/area/template_noop)
"bo" = (
/obj/structure/railing/corner/end{
	pixel_y = 17
	},
/turf/open/floor/wood/tile,
/area/template_noop)
"bt" = (
/obj/structure/window/reinforced/spawner/directional/east,
/obj/structure/window/reinforced/spawner/directional/west,
/obj/structure/flora/bush/fullgrass/style_random,
/obj/structure/flora/bush/grassy/style_random,
/turf/open/floor/grass,
/area/template_noop)
"cs" = (
/obj/structure/table/wood/fancy,
/obj/item/kitchen/fork{
	pixel_x = -7;
	pixel_y = 7;
	layer = 3.5
	},
/obj/item/kitchen/spoon{
	pixel_x = 4;
	pixel_y = 7;
	layer = 3.5
	},
/obj/item/food/cake/berry_chocolate_cake{
	pixel_y = -13;
	layer = 4
	},
/turf/open/floor/wood/parquet,
/area/template_noop)
"cU" = (
/obj/effect/turf_decal/siding/wood{
	dir = 8
	},
/turf/open/floor/iron/kitchen,
/area/template_noop)
"dq" = (
/obj/structure/table/wood/fancy/blue,
/obj/item/plate{
	pixel_y = 3
	},
/obj/effect/turf_decal/siding/wood,
/obj/item/food/breadstick{
	pixel_x = 3;
	pixel_y = 6
	},
/obj/item/food/breadstick{
	pixel_x = -3;
	pixel_y = 2
	},
/turf/open/floor/wood/tile,
/area/template_noop)
"eX" = (
/turf/open/floor/wood/parquet,
/area/template_noop)
"fs" = (
/obj/structure/table/reinforced,
/obj/item/reagent_containers/cup/bowl,
/obj/item/reagent_containers/cup/bowl,
/obj/item/reagent_containers/cup/bowl,
/turf/open/floor/iron/checker,
/area/template_noop)
"fA" = (
/obj/effect/decal/cleanable/dirt,
/obj/machinery/deepfryer,
/turf/open/floor/iron/checker,
/area/template_noop)
"gd" = (
/obj/structure/chair/wood/wings{
	dir = 8
	},
/obj/effect/turf_decal/siding/wood{
	dir = 6
	},
/turf/open/floor/wood/tile,
/area/template_noop)
"gi" = (
/obj/structure/chair/wood/wings{
	dir = 8
	},
/obj/effect/turf_decal/siding/wood{
	dir = 4
	},
/turf/open/floor/wood/tile,
/area/template_noop)
"gH" = (
/obj/structure/chair/wood/wings{
	dir = 8
	},
/obj/effect/turf_decal/siding/wood/corner{
	dir = 4
	},
/turf/open/floor/wood/parquet,
/area/template_noop)
"gI" = (
/obj/structure/hedge,
/turf/open/floor/wood/large,
/area/template_noop)
"hB" = (
/obj/effect/turf_decal/siding/wood,
/turf/open/floor/iron/kitchen,
/area/template_noop)
"hT" = (
/obj/structure/chair/wood/wings{
	dir = 1
	},
/turf/open/floor/wood/parquet,
/area/template_noop)
"iB" = (
/obj/structure/table/reinforced,
/obj/item/food/fried_chicken,
/turf/open/floor/iron/checker,
/area/template_noop)
"iO" = (
/obj/effect/turf_decal/siding/wood{
	dir = 8
	},
/turf/open/floor/wood/tile,
/area/template_noop)
"jo" = (
/obj/structure/window/reinforced/spawner/directional/east,
/obj/structure/window/reinforced/spawner/directional/south,
/obj/structure/window/reinforced/spawner/directional/west,
/obj/structure/flora/bush/fullgrass/style_random,
/obj/structure/flora/bush/grassy/style_random,
/turf/open/floor/grass,
/area/template_noop)
"jE" = (
/obj/structure/railing/corner/end/flip{
	dir = 8
	},
/obj/effect/turf_decal/siding/wood/corner{
	dir = 4
	},
/turf/open/floor/wood/parquet,
/area/template_noop)
"kq" = (
/obj/effect/turf_decal/siding/wood{
	dir = 4
	},
/turf/open/floor/wood/tile,
/area/template_noop)
"kK" = (
/obj/structure/table/wood/fancy/purple,
/obj/item/plate/small{
	pixel_x = -5;
	pixel_y = 8
	},
/obj/item/plate/small{
	pixel_x = 6
	},
/obj/item/food/nigiri_sushi{
	pixel_x = -6;
	pixel_y = 11
	},
/obj/item/food/philadelphia_sushi_slice{
	pixel_x = 7;
	pixel_y = 4
	},
/turf/open/floor/wood/parquet,
/area/template_noop)
"lt" = (
/obj/effect/turf_decal/siding/wood{
	dir = 4
	},
/turf/open/floor/iron/kitchen,
/area/template_noop)
"lz" = (
/obj/structure/railing/corner/end{
	pixel_y = 17;
	dir = 1
	},
/turf/open/floor/wood/tile,
/area/template_noop)
"mP" = (
/obj/structure/railing/corner/end{
	dir = 4
	},
/obj/effect/turf_decal/siding/wood/corner{
	dir = 1
	},
/turf/open/floor/wood/tile,
/area/template_noop)
"nF" = (
/obj/effect/turf_decal/siding/wood{
	dir = 5
	},
/turf/open/floor/wood/parquet,
/area/template_noop)
"os" = (
/obj/effect/turf_decal/siding/wood{
	dir = 5
	},
/obj/machinery/oven/range,
/obj/effect/decal/cleanable/dirt,
/obj/item/food/dough,
/turf/open/floor/iron/checker,
/area/template_noop)
"oE" = (
/obj/structure/table/wood/fancy/orange,
/obj/item/plate/small{
	pixel_x = 6
	},
/obj/item/plate/small{
	pixel_x = -5;
	pixel_y = 8
	},
/obj/item/flashlight/flare/candle{
	pixel_y = -11
	},
/obj/item/food/cherrycupcake{
	pixel_x = 6;
	pixel_y = 4
	},
/obj/item/food/cherrycupcake/blue{
	pixel_y = 11;
	pixel_x = -4
	},
/turf/open/floor/wood/parquet,
/area/template_noop)
"pg" = (
/obj/structure/railing{
	dir = 9
	},
/turf/open/floor/wood/tile,
/area/template_noop)
"pC" = (
/obj/structure/chair/wood/wings{
	dir = 1
	},
/obj/effect/turf_decal/siding/wood,
/turf/open/floor/wood/parquet,
/area/template_noop)
"pR" = (
/obj/effect/turf_decal/siding/wood{
	dir = 1
	},
/turf/open/floor/iron/kitchen,
/area/template_noop)
"pW" = (
/obj/structure/table/wood/fancy/orange,
/obj/item/reagent_containers/cup/glass/bottle/wine/unlabeled{
	pixel_y = 11;
	layer = 3.5
	},
/turf/open/floor/wood/parquet,
/area/template_noop)
"qC" = (
/obj/effect/turf_decal/siding/wood{
	dir = 10
	},
/obj/machinery/oven/range,
/obj/effect/decal/cleanable/dirt,
/obj/item/food/dough,
/turf/open/floor/iron/checker,
/area/template_noop)
"rh" = (
/obj/structure/table/wood/fancy/black,
/obj/item/plate/large{
	pixel_y = 18
	},
/obj/item/kitchen/spoon{
	pixel_x = 4
	},
/obj/item/kitchen/fork{
	pixel_x = -7
	},
/turf/open/floor/wood/parquet,
/area/template_noop)
"rj" = (
/obj/effect/turf_decal/siding/dark{
	dir = 8
	},
/turf/open/floor/stone,
/area/template_noop)
"rs" = (
/obj/structure/railing{
	dir = 6
	},
/turf/open/floor/wood/tile,
/area/template_noop)
"sg" = (
/obj/structure/railing/corner/end/flip{
	dir = 4
	},
/obj/effect/turf_decal/siding/wood/corner{
	dir = 8
	},
/turf/open/floor/wood/tile,
/area/template_noop)
"tW" = (
/obj/effect/turf_decal/siding/wood/corner{
	dir = 1
	},
/turf/open/floor/wood/parquet,
/area/template_noop)
"ud" = (
/obj/effect/turf_decal/siding/wood{
	dir = 6
	},
/obj/effect/decal/cleanable/dirt,
/obj/machinery/griddle,
/obj/item/food/raw_patty{
	pixel_x = -6
	},
/obj/item/food/meat/rawbacon{
	pixel_x = -1;
	pixel_y = 9
	},
/obj/item/food/rawegg{
	pixel_x = 7;
	pixel_y = 2
	},
/turf/open/floor/iron/checker,
/area/template_noop)
"uD" = (
/obj/structure/table/reinforced,
/obj/item/food/nachos{
	pixel_y = 7
	},
/obj/item/food/taco{
	pixel_x = -6;
	pixel_y = -1
	},
/obj/item/reagent_containers/cup/bottle/capsaicin{
	pixel_x = -12;
	pixel_y = 9
	},
/turf/open/floor/iron/checker,
/area/template_noop)
"vi" = (
/obj/effect/turf_decal/siding/wood{
	dir = 10
	},
/turf/open/floor/wood/parquet,
/area/template_noop)
"vt" = (
/obj/structure/table/reinforced,
/obj/structure/reagent_dispensers/servingdish,
/turf/open/floor/iron/checker,
/area/template_noop)
"wb" = (
/obj/structure/railing/corner,
/obj/effect/turf_decal/siding/wood{
	dir = 1
	},
/turf/open/floor/wood/parquet,
/area/template_noop)
"yb" = (
/obj/structure/railing{
	dir = 5
	},
/turf/open/floor/wood/tile,
/area/template_noop)
"yz" = (
/obj/structure/window/reinforced/spawner/directional/east,
/obj/structure/window/reinforced/spawner/directional/south,
/obj/structure/window/reinforced/spawner/directional/west,
/obj/structure/flora/bush/fullgrass/style_random,
/turf/open/floor/grass,
/area/template_noop)
"zF" = (
/obj/structure/railing{
	dir = 8;
	pixel_y = 17
	},
/obj/structure/railing/corner/end/flip{
	dir = 1;
	pixel_y = -15
	},
/turf/open/floor/wood/tile,
/area/template_noop)
"zG" = (
/obj/structure/railing,
/obj/effect/turf_decal/siding/wood{
	dir = 1
	},
/turf/open/floor/wood/parquet,
/area/template_noop)
"BH" = (
/obj/effect/turf_decal/siding/wood{
	dir = 10
	},
/obj/machinery/light/floor,
/turf/open/floor/iron/kitchen,
/area/template_noop)
"BV" = (
/obj/structure/chair/wood/wings{
	dir = 4
	},
/obj/effect/turf_decal/siding/wood{
	dir = 8
	},
/turf/open/floor/wood/tile,
/area/template_noop)
"Ch" = (
/obj/structure/fake_stairs/wood/directional/east,
/turf/open/floor/iron/terracotta/diagonal,
/area/template_noop)
"Ex" = (
/obj/effect/turf_decal/siding/wood{
	dir = 9
	},
/turf/open/floor/wood/parquet,
/area/template_noop)
"Fj" = (
/turf/open/floor/wood/tile,
/area/template_noop)
"Fu" = (
/obj/effect/turf_decal/siding/wood{
	dir = 5
	},
/obj/machinery/light/floor,
/turf/open/floor/iron/kitchen,
/area/template_noop)
"FB" = (
/obj/structure/chair/wood/wings{
	dir = 4
	},
/obj/effect/turf_decal/siding/wood/corner{
	dir = 8
	},
/turf/open/floor/wood/parquet,
/area/template_noop)
"FZ" = (
/obj/structure/table/wood/fancy,
/obj/item/plate/large{
	pixel_y = 18
	},
/obj/item/cigarette/cigar,
/turf/open/floor/wood/parquet,
/area/template_noop)
"GI" = (
/obj/structure/railing{
	dir = 10
	},
/turf/open/floor/wood/tile,
/area/template_noop)
"Ij" = (
/obj/structure/table/wood/fancy/green,
/obj/item/reagent_containers/condiment/peppermill{
	pixel_y = 6;
	pixel_x = -4
	},
/obj/item/reagent_containers/condiment/saltshaker{
	pixel_y = 6;
	pixel_x = 3
	},
/turf/open/floor/wood/parquet,
/area/template_noop)
"IS" = (
/obj/machinery/light/floor,
/turf/open/floor/iron/checker,
/area/template_noop)
"IU" = (
/obj/structure/chair/wood/wings{
	dir = 4
	},
/obj/effect/turf_decal/siding/wood{
	dir = 10
	},
/turf/open/floor/wood/tile,
/area/template_noop)
"IX" = (
/obj/structure/railing/corner{
	dir = 1
	},
/obj/effect/turf_decal/siding/wood,
/turf/open/floor/wood/parquet,
/area/template_noop)
"Jk" = (
/obj/structure/window/reinforced/spawner/directional/east,
/obj/structure/window/reinforced/spawner/directional/west,
/obj/structure/flora/rock/pile/style_random,
/obj/structure/flora/bush/sparsegrass/style_random,
/turf/open/floor/grass,
/area/template_noop)
"JE" = (
/obj/effect/turf_decal/siding/wood{
	dir = 4
	},
/obj/effect/decal/cleanable/food/egg_smudge,
/turf/open/floor/iron/kitchen,
/area/template_noop)
"JR" = (
/obj/structure/window/reinforced/spawner/directional/east,
/obj/structure/window/reinforced/spawner/directional/north,
/obj/structure/window/reinforced/spawner/directional/west,
/obj/structure/flora/bush/fullgrass/style_random,
/obj/structure/flora/bush/grassy/style_random,
/turf/open/floor/grass,
/area/template_noop)
"JU" = (
/obj/structure/railing{
	dir = 1
	},
/obj/effect/turf_decal/siding/wood,
/turf/open/floor/wood/parquet,
/area/template_noop)
"Ki" = (
/obj/effect/turf_decal/siding/wood{
	dir = 9
	},
/obj/effect/decal/cleanable/dirt,
/obj/machinery/griddle,
/obj/item/food/raw_patty{
	pixel_x = -6
	},
/obj/item/food/meat/rawbacon{
	pixel_x = -1;
	pixel_y = 9
	},
/obj/item/food/rawegg{
	pixel_x = 7;
	pixel_y = 2
	},
/turf/open/floor/iron/checker,
/area/template_noop)
"Mt" = (
/obj/structure/table/wood/fancy/black,
/obj/item/cigarette/cigar{
	pixel_y = 6
	},
/obj/item/food/cake/berry_vanilla_cake{
	pixel_y = -14
	},
/turf/open/floor/wood/parquet,
/area/template_noop)
"Ni" = (
/obj/structure/table/reinforced,
/obj/item/food/nachos,
/obj/item/food/taco{
	pixel_x = 7;
	pixel_y = 6
	},
/turf/open/floor/iron/checker,
/area/template_noop)
"NI" = (
/obj/effect/turf_decal/siding/wood{
	dir = 9
	},
/obj/machinery/light/floor,
/turf/open/floor/iron/kitchen,
/area/template_noop)
"NM" = (
/obj/structure/chair/wood/wings{
	dir = 4
	},
/obj/effect/turf_decal/siding/wood{
	dir = 9
	},
/turf/open/floor/wood/tile,
/area/template_noop)
"NO" = (
/obj/structure/railing/corner/end{
	dir = 8
	},
/obj/effect/turf_decal/siding/wood/corner,
/turf/open/floor/wood/tile,
/area/template_noop)
"Oi" = (
/obj/effect/turf_decal/siding/wood{
	dir = 8
	},
/obj/effect/decal/cleanable/food/flour,
/turf/open/floor/iron/kitchen,
/area/template_noop)
"OJ" = (
/obj/effect/turf_decal/siding/wood{
	dir = 6
	},
/turf/open/floor/wood/parquet,
/area/template_noop)
"Qk" = (
/turf/open/floor/iron/checker,
/area/template_noop)
"RZ" = (
/obj/effect/turf_decal/siding/wood{
	dir = 6
	},
/obj/machinery/light/floor,
/turf/open/floor/iron/kitchen,
/area/template_noop)
"Sn" = (
/obj/structure/chair/wood/wings{
	dir = 4
	},
/turf/open/floor/wood/parquet,
/area/template_noop)
"Ss" = (
/obj/structure/railing/corner{
	dir = 4
	},
/obj/effect/turf_decal/siding/wood,
/turf/open/floor/wood/parquet,
/area/template_noop)
"SL" = (
/obj/structure/table/wood/fancy/orange,
/obj/item/plate/small{
	pixel_x = 6
	},
/obj/item/plate/small{
	pixel_x = -5;
	pixel_y = 8
	},
/obj/effect/turf_decal/siding/wood,
/obj/item/food/philadelphia_sushi_slice{
	pixel_x = 7;
	pixel_y = 4
	},
/obj/item/food/nigiri_sushi{
	pixel_x = -6;
	pixel_y = 11
	},
/turf/open/floor/wood/tile,
/area/template_noop)
"SS" = (
/obj/structure/window/reinforced/spawner/directional/east,
/obj/structure/window/reinforced/spawner/directional/west,
/obj/structure/flora/bush/fullgrass/style_random,
/turf/open/floor/grass,
/area/template_noop)
"Tq" = (
/obj/structure/railing/corner{
	dir = 8
	},
/obj/effect/turf_decal/siding/wood{
	dir = 1
	},
/turf/open/floor/wood/parquet,
/area/template_noop)
"Tw" = (
/obj/structure/table/reinforced,
/obj/item/rag{
	pixel_x = 4;
	pixel_y = 13
	},
/turf/open/floor/iron/checker,
/area/template_noop)
"TD" = (
/obj/structure/table/wood/fancy/purple,
/obj/item/reagent_containers/cup/glass/bottle/wine/unlabeled{
	pixel_y = 11;
	layer = 3.5
	},
/turf/open/floor/wood/parquet,
/area/template_noop)
"Up" = (
/obj/structure/table/wood/fancy/blue,
/obj/item/reagent_containers/condiment/saltshaker{
	pixel_y = 6;
	pixel_x = 3
	},
/obj/item/reagent_containers/condiment/peppermill{
	pixel_y = 6;
	pixel_x = -4
	},
/turf/open/floor/wood/parquet,
/area/template_noop)
"Ut" = (
/obj/effect/turf_decal/siding/dark{
	dir = 4
	},
/turf/open/floor/stone,
/area/template_noop)
"UH" = (
/obj/structure/chair/wood/wings{
	dir = 8
	},
/obj/effect/turf_decal/siding/wood{
	dir = 5
	},
/turf/open/floor/wood/tile,
/area/template_noop)
"Vh" = (
/obj/structure/railing{
	dir = 4;
	pixel_y = -16
	},
/obj/structure/railing/corner/end/flip{
	pixel_y = 16
	},
/turf/open/floor/wood/tile,
/area/template_noop)
"Xf" = (
/obj/effect/turf_decal/siding/wood/corner,
/turf/open/floor/wood/parquet,
/area/template_noop)
"Xt" = (
/obj/structure/chair/wood/wings,
/turf/open/floor/wood/parquet,
/area/template_noop)
"XE" = (
/obj/structure/table/wood/fancy/green,
/obj/item/plate{
	pixel_y = 3
	},
/obj/effect/turf_decal/siding/wood{
	dir = 1
	},
/obj/item/food/breadstick{
	pixel_x = -3;
	pixel_y = 2
	},
/obj/item/food/breadstick{
	pixel_x = 3;
	pixel_y = 6
	},
/turf/open/floor/wood/tile,
/area/template_noop)
"Yr" = (
/obj/structure/table/wood/fancy/purple,
/obj/item/plate/small{
	pixel_x = 6
	},
/obj/item/plate/small{
	pixel_x = -5;
	pixel_y = 8
	},
/obj/effect/turf_decal/siding/wood{
	dir = 1
	},
/obj/item/flashlight/flare/candle{
	pixel_y = -11
	},
/obj/item/food/cherrycupcake/blue{
	pixel_y = 11;
	pixel_x = -4
	},
/obj/item/food/cherrycupcake{
	pixel_x = 6;
	pixel_y = 4
	},
/turf/open/floor/wood/tile,
/area/template_noop)
"Yv" = (
/obj/structure/fake_stairs/wood/directional/west,
/turf/open/floor/iron/terracotta/diagonal,
/area/template_noop)
"Yw" = (
/obj/structure/chair/wood/wings{
	dir = 8
	},
/turf/open/floor/wood/parquet,
/area/template_noop)
"YD" = (
/obj/structure/window/reinforced/spawner/directional/east,
/obj/structure/window/reinforced/spawner/directional/north,
/obj/structure/window/reinforced/spawner/directional/west,
/obj/structure/flora/rock/pile/style_random,
/obj/structure/flora/bush/sparsegrass/style_random,
/turf/open/floor/grass,
/area/template_noop)
"ZO" = (
/obj/structure/chair/wood/wings,
/obj/effect/turf_decal/siding/wood{
	dir = 1
	},
/turf/open/floor/wood/parquet,
/area/template_noop)

(1,1,1) = {"
Ut
Ut
Ut
Ut
Ut
Ut
Ut
Ut
Ut
Ut
"}
(2,1,1) = {"
Qk
NM
BV
iO
iO
iO
iO
iO
IU
Qk
"}
(3,1,1) = {"
IS
Yr
kK
eX
Sn
Sn
eX
Xt
dq
IS
"}
(4,1,1) = {"
Qk
UH
gH
Sn
cs
FZ
Sn
Xf
gd
Qk
"}
(5,1,1) = {"
Jk
jo
ZO
TD
Yw
Yw
Up
pC
JR
SS
"}
(6,1,1) = {"
vt
Ex
mP
Fj
Vh
Fj
lz
sg
vi
iB
"}
(7,1,1) = {"
vt
wb
rs
Yv
Ki
qC
Yv
yb
Ss
Tw
"}
(8,1,1) = {"
fs
zG
gI
NI
Oi
cU
BH
gI
JU
uD
"}
(9,1,1) = {"
IS
zG
gI
pR
fA
fA
hB
gI
JU
IS
"}
(10,1,1) = {"
Ni
zG
gI
Fu
lt
JE
RZ
gI
JU
fs
"}
(11,1,1) = {"
aa
Tq
GI
Ch
os
ud
Ch
pg
IX
vt
"}
(12,1,1) = {"
iB
nF
jE
Fj
bo
zF
Fj
NO
OJ
vt
"}
(13,1,1) = {"
bt
yz
ZO
Ij
Sn
Sn
pW
pC
YD
SS
"}
(14,1,1) = {"
Qk
NM
tW
Yw
Mt
rh
Yw
FB
IU
Qk
"}
(15,1,1) = {"
IS
XE
hT
eX
Yw
Yw
eX
oE
SL
IS
"}
(16,1,1) = {"
Qk
UH
kq
kq
kq
kq
kq
gi
gd
Qk
"}
(17,1,1) = {"
rj
rj
rj
rj
rj
rj
rj
rj
rj
rj
"}
