//MAP CONVERTED BY dmm2tgm.py THIS HEADER COMMENT PREVENTS RECONVERSION, DO NOT REMOVE
"df" = (
/obj/structure/table/wood,
/obj/item/storage/fancy/cigarettes/cigars/havana,
/obj/item/lighter,
/obj/effect/turf_decal/siding/wood{
	dir = 1
	},
/turf/open/floor/wood/tile,
/area/template_noop)
"di" = (
/obj/effect/turf_decal/siding/wood{
	dir = 8
	},
/turf/open/floor/carpet/green,
/area/template_noop)
"ej" = (
/obj/structure/flora/bush/grassy/style_random,
/obj/structure/flora/bush/flowers_pp/style_random,
/obj/structure/window/reinforced/spawner/directional/west,
/obj/structure/window/reinforced/spawner/directional/east,
/turf/open/floor/grass,
/area/template_noop)
"eM" = (
/obj/structure/table/wood,
/obj/item/reagent_containers/cup/glass/drinkingglass{
	pixel_x = -8;
	pixel_y = 11
	},
/obj/effect/turf_decal/siding/wood{
	dir = 1
	},
/obj/item/reagent_containers/cup/glass/drinkingglass{
	pixel_x = 1;
	pixel_y = 11
	},
/obj/item/reagent_containers/cup/glass/drinkingglass{
	pixel_x = 10;
	pixel_y = 11
	},
/obj/item/reagent_containers/cup/glass/drinkingglass{
	pixel_x = -8;
	pixel_y = 1
	},
/obj/item/reagent_containers/cup/glass/drinkingglass{
	pixel_x = 1;
	pixel_y = 1
	},
/obj/item/reagent_containers/cup/glass/drinkingglass{
	pixel_x = 10;
	pixel_y = 1
	},
/turf/open/floor/wood/tile,
/area/template_noop)
"eX" = (
/obj/structure/fake_stairs/wood/directional/west,
/obj/structure/railing,
/turf/open/floor/carpet/red,
/area/template_noop)
"eY" = (
/obj/structure/railing/corner/end/flip{
	dir = 8
	},
/turf/open/floor/carpet/red,
/area/template_noop)
"hv" = (
/obj/structure/chair/wood,
/obj/structure/railing{
	dir = 8
	},
/obj/effect/turf_decal/siding/wood{
	dir = 8
	},
/obj/item/toy/plush/abductor,
/turf/open/floor/carpet/green,
/area/template_noop)
"hI" = (
/obj/effect/turf_decal/siding/wood{
	dir = 8
	},
/turf/open/floor/wood/tile,
/area/template_noop)
"hK" = (
/obj/machinery/light/floor,
/turf/open/floor/carpet/red,
/area/template_noop)
"iB" = (
/obj/effect/turf_decal/siding/wood/corner,
/obj/structure/railing/corner,
/turf/open/floor/carpet/green,
/area/template_noop)
"jj" = (
/obj/structure/chair/stool/bar/directional/south,
/turf/open/floor/carpet/red,
/area/template_noop)
"jp" = (
/obj/item/flashlight/flare/candle/infinite{
	pixel_y = 6
	},
/obj/effect/turf_decal/siding/wood{
	dir = 8
	},
/obj/structure/railing{
	dir = 8
	},
/obj/structure/table/wood/fancy/red,
/turf/open/floor/carpet/green,
/area/template_noop)
"ke" = (
/obj/structure/chair/wood{
	dir = 8
	},
/turf/open/floor/carpet/red,
/area/template_noop)
"kv" = (
/obj/structure/chair/wood{
	dir = 4
	},
/turf/open/floor/carpet/red,
/area/template_noop)
"mg" = (
/obj/structure/table/wood,
/obj/item/reagent_containers/cup/glass/bottle/beer,
/obj/effect/turf_decal/siding/wood{
	dir = 5
	},
/turf/open/floor/wood/tile,
/area/template_noop)
"nh" = (
/obj/effect/turf_decal/siding/wood/corner{
	dir = 1
	},
/obj/structure/railing/corner{
	dir = 1
	},
/turf/open/floor/carpet/green,
/area/template_noop)
"ni" = (
/obj/structure/table/wood,
/obj/item/storage/fancy/cigarettes/cigars/cohiba,
/obj/effect/turf_decal/siding/wood,
/obj/item/lighter,
/turf/open/floor/wood/tile,
/area/template_noop)
"nI" = (
/obj/structure/table/wood/fancy/green,
/obj/item/flashlight/flare/candle/infinite{
	pixel_y = 6
	},
/turf/open/floor/carpet/red,
/area/template_noop)
"nQ" = (
/turf/open/floor/carpet/red,
/area/template_noop)
"oA" = (
/obj/structure/table/wood,
/obj/item/plate/large,
/obj/item/food/bbqribs{
	pixel_y = 5
	},
/obj/effect/turf_decal/siding/wood,
/turf/open/floor/wood/tile,
/area/template_noop)
"oK" = (
/obj/structure/statue/bananium/clown{
	icon_state = "jukebox";
	icon = 'icons/obj/machines/music.dmi';
	name = "Dysfunctional Jukebox";
	desc = "You're not quite sure why it doesn't work..."
	},
/turf/open/floor/carpet/red,
/area/template_noop)
"oP" = (
/obj/structure/table/wood,
/obj/effect/turf_decal/siding/wood{
	dir = 6
	},
/obj/item/reagent_containers/cup/glass/flask/gold,
/turf/open/floor/wood/tile,
/area/template_noop)
"oS" = (
/obj/structure/flora/bush/grassy/style_random,
/obj/structure/flora/bush/flowers_yw/style_random,
/mob/living/basic/butterfly,
/obj/structure/window/reinforced/spawner/directional/west,
/obj/structure/window/reinforced/spawner/directional/east,
/obj/structure/window/reinforced/spawner/directional/north,
/turf/open/floor/grass,
/area/template_noop)
"pI" = (
/obj/structure/chair/stool/bar/directional/north,
/turf/open/floor/carpet/red,
/area/template_noop)
"pV" = (
/turf/open/floor/wood/tile,
/area/template_noop)
"qA" = (
/obj/structure/railing/corner/end{
	dir = 4
	},
/turf/open/floor/carpet/red,
/area/template_noop)
"ri" = (
/obj/structure/flora/bush/grassy/style_random,
/obj/structure/flora/bush/flowers_br/style_random,
/obj/structure/window/reinforced/spawner/directional/west,
/obj/structure/window/reinforced/spawner/directional/east,
/turf/open/floor/grass,
/area/template_noop)
"rT" = (
/obj/structure/fake_stairs/wood/directional/west,
/obj/structure/railing{
	dir = 1
	},
/turf/open/floor/carpet/red,
/area/template_noop)
"sW" = (
/obj/structure/table/wood,
/obj/effect/turf_decal/siding/wood,
/obj/item/dice/d20,
/turf/open/floor/wood/tile,
/area/template_noop)
"tG" = (
/obj/structure/chair/wood{
	dir = 1
	},
/obj/structure/railing{
	dir = 4
	},
/obj/effect/turf_decal/siding/wood{
	dir = 4
	},
/obj/item/toy/plush/moth,
/turf/open/floor/carpet/green,
/area/template_noop)
"vr" = (
/obj/effect/turf_decal/siding/wood{
	dir = 8
	},
/obj/structure/railing/corner{
	dir = 1
	},
/turf/open/floor/carpet/green,
/area/template_noop)
"xg" = (
/turf/open/floor/carpet/green,
/area/template_noop)
"yd" = (
/obj/structure/flora/bush/grassy/style_random,
/obj/structure/flora/bush/flowers_br/style_random,
/mob/living/basic/butterfly,
/obj/structure/window/reinforced/spawner/directional/south,
/obj/structure/window/reinforced/spawner/directional/east,
/obj/structure/window/reinforced/spawner/directional/west,
/turf/open/floor/grass,
/area/template_noop)
"yT" = (
/obj/structure/flora/bush/grassy/style_random,
/obj/structure/flora/bush/flowers_pp/style_random,
/mob/living/basic/butterfly,
/obj/structure/window/reinforced/spawner/directional/north,
/obj/structure/window/reinforced/spawner/directional/east,
/obj/structure/window/reinforced/spawner/directional/west,
/turf/open/floor/grass,
/area/template_noop)
"Ak" = (
/obj/structure/table/wood,
/obj/item/plate/small,
/obj/item/food/burger,
/obj/effect/turf_decal/siding/wood,
/turf/open/floor/wood/tile,
/area/template_noop)
"AJ" = (
/obj/effect/turf_decal/siding/wood/corner{
	dir = 8
	},
/obj/structure/railing/corner{
	dir = 8
	},
/turf/open/floor/carpet/green,
/area/template_noop)
"AS" = (
/obj/structure/flora/bush/grassy/style_random,
/obj/structure/flora/bush/flowers_yw/style_random,
/mob/living/basic/butterfly,
/obj/structure/window/reinforced/spawner/directional/north,
/obj/structure/window/reinforced/spawner/directional/west,
/obj/structure/window/reinforced/spawner/directional/east,
/turf/open/floor/grass,
/area/template_noop)
"Ca" = (
/obj/structure/chair/wood{
	dir = 1
	},
/obj/structure/railing{
	dir = 8
	},
/obj/effect/turf_decal/siding/wood{
	dir = 8
	},
/obj/item/toy/plush/ratplush,
/turf/open/floor/carpet/green,
/area/template_noop)
"CO" = (
/obj/structure/flora/bush/grassy/style_random,
/obj/structure/flora/bush/flowers_yw/style_random,
/mob/living/basic/butterfly,
/obj/structure/window/reinforced/spawner/directional/west,
/obj/structure/window/reinforced/spawner/directional/east,
/obj/structure/window/reinforced/spawner/directional/south,
/turf/open/floor/grass,
/area/template_noop)
"En" = (
/obj/structure/flora/bush/grassy/style_random,
/obj/structure/flora/bush/flowers_yw/style_random,
/obj/structure/window/reinforced/spawner/directional/east,
/obj/structure/window/reinforced/spawner/directional/west,
/turf/open/floor/grass,
/area/template_noop)
"EU" = (
/obj/structure/flora/bush/grassy/style_random,
/obj/structure/flora/bush/flowers_br/style_random,
/mob/living/basic/butterfly,
/obj/structure/window/reinforced/spawner/directional/east,
/obj/structure/window/reinforced/spawner/directional/west,
/obj/structure/window/reinforced/spawner/directional/north,
/turf/open/floor/grass,
/area/template_noop)
"FH" = (
/obj/structure/chair/wood,
/obj/structure/railing{
	dir = 4
	},
/obj/effect/turf_decal/siding/wood{
	dir = 4
	},
/obj/item/toy/plush/lizard_plushie/green,
/turf/open/floor/carpet/green,
/area/template_noop)
"Gr" = (
/obj/effect/turf_decal/siding/wood/corner{
	dir = 4
	},
/obj/structure/railing/corner{
	dir = 4
	},
/turf/open/floor/carpet/green,
/area/template_noop)
"Hc" = (
/obj/structure/fake_stairs/wood/directional/east,
/obj/structure/railing,
/turf/open/floor/carpet/red,
/area/template_noop)
"HO" = (
/obj/structure/table/wood,
/obj/machinery/chem_dispenser/drinks/beer/fullupgrade,
/obj/effect/turf_decal/siding/wood{
	dir = 1
	},
/turf/open/floor/wood/tile,
/area/template_noop)
"IC" = (
/obj/structure/chair/wood{
	dir = 4
	},
/obj/item/bouquet/rose,
/turf/open/floor/carpet/red,
/area/template_noop)
"IL" = (
/obj/structure/fake_stairs/wood/directional/east,
/obj/structure/railing{
	dir = 1
	},
/turf/open/floor/carpet/red,
/area/template_noop)
"Ka" = (
/obj/structure/table/wood,
/obj/item/reagent_containers/cup/glass/bottle/whiskey,
/obj/effect/turf_decal/siding/wood{
	dir = 1
	},
/turf/open/floor/wood/tile,
/area/template_noop)
"Mp" = (
/obj/structure/chair/wood,
/obj/item/toy/plush/narplush,
/obj/structure/railing{
	dir = 9
	},
/obj/effect/turf_decal/siding/wood{
	dir = 9
	},
/turf/open/floor/carpet/green,
/area/template_noop)
"Ot" = (
/obj/structure/flora/bush/grassy/style_random,
/obj/structure/flora/bush/flowers_yw/style_random,
/mob/living/basic/butterfly,
/obj/structure/window/reinforced/spawner/directional/south,
/obj/structure/window/reinforced/spawner/directional/west,
/obj/structure/window/reinforced/spawner/directional/east,
/turf/open/floor/grass,
/area/template_noop)
"Pb" = (
/obj/structure/railing/corner/end/flip{
	dir = 4
	},
/turf/open/floor/carpet/red,
/area/template_noop)
"PU" = (
/obj/structure/table/wood,
/obj/machinery/chem_dispenser/drinks/fullupgrade,
/obj/effect/turf_decal/siding/wood{
	dir = 1
	},
/turf/open/floor/wood/tile,
/area/template_noop)
"Qk" = (
/obj/structure/chair/wood,
/obj/item/toy/plush/beeplushie,
/obj/structure/railing{
	dir = 5
	},
/obj/effect/turf_decal/siding/wood{
	dir = 5
	},
/turf/open/floor/carpet/green,
/area/template_noop)
"Rv" = (
/obj/structure/chair/wood{
	dir = 1
	},
/obj/item/toy/plush/plasmamanplushie,
/obj/structure/railing{
	dir = 6
	},
/obj/effect/turf_decal/siding/wood{
	dir = 6
	},
/turf/open/floor/carpet/green,
/area/template_noop)
"St" = (
/obj/structure/flora/bush/grassy/style_random,
/obj/structure/flora/bush/flowers_pp/style_random,
/mob/living/basic/butterfly,
/obj/structure/window/reinforced/spawner/directional/east,
/obj/structure/window/reinforced/spawner/directional/west,
/obj/structure/window/reinforced/spawner/directional/south,
/turf/open/floor/grass,
/area/template_noop)
"SB" = (
/obj/structure/table/wood,
/obj/item/plate/small,
/obj/item/food/fries,
/obj/effect/turf_decal/siding/wood{
	dir = 9
	},
/turf/open/floor/wood/tile,
/area/template_noop)
"Ub" = (
/obj/structure/table/wood,
/obj/effect/turf_decal/siding/wood{
	dir = 10
	},
/obj/item/reagent_containers/cup/glass/bottle/beer,
/turf/open/floor/wood/tile,
/area/template_noop)
"Um" = (
/obj/item/kirbyplants/organic/plant21,
/turf/open/floor/carpet/red,
/area/template_noop)
"Uv" = (
/obj/structure/fake_stairs/wood/directional/east,
/turf/open/floor/carpet/red,
/area/template_noop)
"UW" = (
/obj/effect/turf_decal/siding/wood{
	dir = 4
	},
/turf/open/floor/wood/tile,
/area/template_noop)
"Vi" = (
/obj/structure/railing/corner/end{
	dir = 8
	},
/turf/open/floor/carpet/red,
/area/template_noop)
"Vp" = (
/obj/effect/turf_decal/siding/wood{
	dir = 8
	},
/obj/structure/railing/corner{
	dir = 8
	},
/turf/open/floor/carpet/green,
/area/template_noop)
"Vv" = (
/obj/effect/turf_decal/siding/wood{
	dir = 4
	},
/turf/open/floor/carpet/green,
/area/template_noop)
"VW" = (
/obj/structure/chair/wood{
	dir = 1
	},
/obj/item/toy/plush/nukeplushie,
/obj/structure/railing{
	dir = 10
	},
/obj/effect/turf_decal/siding/wood{
	dir = 10
	},
/turf/open/floor/carpet/green,
/area/template_noop)
"Ws" = (
/obj/structure/fake_stairs/wood/directional/west,
/turf/open/floor/carpet/red,
/area/template_noop)
"WX" = (
/obj/structure/railing{
	dir = 4
	},
/obj/effect/turf_decal/siding/wood{
	dir = 4
	},
/obj/item/flashlight/flare/candle/infinite{
	pixel_y = 6
	},
/obj/structure/table/wood/fancy/red,
/turf/open/floor/carpet/green,
/area/template_noop)
"XL" = (
/obj/structure/table/wood,
/obj/item/reagent_containers/cup/glass/bottle/whiskey,
/obj/effect/turf_decal/siding/wood,
/turf/open/floor/wood/tile,
/area/template_noop)
"Ye" = (
/obj/effect/turf_decal/siding/wood{
	dir = 4
	},
/obj/structure/railing/corner,
/turf/open/floor/carpet/green,
/area/template_noop)
"Zq" = (
/obj/effect/turf_decal/siding/wood{
	dir = 4
	},
/obj/structure/railing/corner{
	dir = 4
	},
/turf/open/floor/carpet/green,
/area/template_noop)

(1,1,1) = {"
EU
En
yd
xg
xg
xg
xg
yT
En
St
"}
(2,1,1) = {"
xg
xg
iB
Zq
Vv
Vv
Ye
Gr
xg
xg
"}
(3,1,1) = {"
FH
WX
Rv
rT
Ws
Ws
eX
Qk
WX
tG
"}
(4,1,1) = {"
Um
nQ
hK
Vi
nQ
nQ
eY
hK
nQ
Um
"}
(5,1,1) = {"
kv
nQ
nQ
nQ
nQ
nQ
nQ
nQ
nQ
kv
"}
(6,1,1) = {"
nI
nQ
jj
SB
hI
hI
Ub
pI
nQ
nI
"}
(7,1,1) = {"
ke
nQ
jj
Ka
pV
pV
ni
pI
nQ
ke
"}
(8,1,1) = {"
nQ
nQ
jj
HO
pV
pV
Ak
pI
nQ
nQ
"}
(9,1,1) = {"
oK
nQ
jj
eM
pV
pV
sW
pI
nQ
nQ
"}
(10,1,1) = {"
nQ
nQ
jj
PU
pV
pV
oA
pI
nQ
nQ
"}
(11,1,1) = {"
IC
nQ
jj
df
pV
pV
XL
pI
nQ
kv
"}
(12,1,1) = {"
nI
nQ
jj
mg
UW
UW
oP
pI
nQ
nI
"}
(13,1,1) = {"
ke
nQ
nQ
nQ
nQ
nQ
nQ
nQ
nQ
ke
"}
(14,1,1) = {"
Um
nQ
hK
Pb
nQ
nQ
qA
hK
nQ
Um
"}
(15,1,1) = {"
hv
jp
VW
IL
Uv
Uv
Hc
Mp
jp
Ca
"}
(16,1,1) = {"
xg
xg
AJ
vr
di
di
Vp
nh
xg
xg
"}
(17,1,1) = {"
oS
ej
Ot
xg
xg
xg
xg
AS
ri
CO
"}
